┌────┬───┬───────────────────────┐
│ O  │   │                     X │
│    │   │  ┌────────────────────┤
│    │   │  │                    │
│    │   │  │                    │
│    │   │  └────────────────────┤
│    │   │                       │
│    │   ├───────────────────┐   │
│    │   │                   │   │
│    └───┴─────────┬───┬─────┘   │
│                  │   │         │
│         ┌────┐   │   │  ┌──────┤
│         │    │   │   │  │      │
│         │    │   │   │  │      │
│         │    │   └───┘  └──────┤
│         │    │                 │
└─────────┴────┴─────────────────┘