┌─┬─┬─┬─┬───┬──┬──────┬─┬─┐
│O│ │ │ │   │  │      │ │X│
│ │ │ │ │   │  │      │ │ │
│ │ │ │ │   │  │      │ │ │
│ │ │ │ │   │  │      │ │ │
│ └─┘ │ │   │  │  ┌─┐ │ │ │
│     └─┘   │  │  │ │ │ │ │
│           │  │  │ │ │ │ │
├┐ ┌─┐  ┌─┐ │  │  │ │ │ │ │
││ │ │  │ │ │  │  │ │ │ │ │
├┘ │ │  │ │ └──┘  │ │ │ │ │
│ ┌┤ │  │ │       │ │ └─┘ │
│ ││ │  │ │       │ │     │
└─┴┴─┴──┴─┴───────┴─┴─────┘