┌─────────┬─────────┬─┬─┐
│         │O        │ │ │
│ │ ┌─┬── └── │ ┌── │ │ │
│ │ │ │       │ │   │   │
│ │ │ │ ──┬───┤ └───┴─┐ │
│ │   │   │   │       │ │
│ └─┐ └─┐ ├─┐ └─┐ ──┐ │ │
│   │   │ │ │   │   │   │
├───┼───┘ │ ├── └───┴── │
│   │     │ │           │
│ ──┘ ┌─┬─┘ └─────┐ ┌── │
│     │ │         │ │   │
├── │ │ │ ┌────── └─┤ ──┤
│   │ │   │         │   │
│ ┌─┴─┴─┐ ├─┬── │ ┌─┴─┐ │
│ │     │ │ │   │ │   │ │
│ │ │ │ └─┘ │ │ ├─┤ │ │ │
│ │ │ │     │ │ │ │ │ │ │
│ ├─┴─┼─┬── │ └─┘ ├─┘ │ │
│ │   │ │         │   │ │
│ │ │ │ │ ┌─   ───┤ ┌─┘ │
│   │ │ │ │       │ │   │
│ ──┤ │ └─┴─┬──── │ │ │ │
│   │       │X        │ │
└───┴───────┴─────────┴─┘          